100 25
W W W W W W W W W W W W W W W W W W W W W W W W W W W W W W W W W W W W W W W W W W W W W W W W W W W W W W W W W W W W W W W W W W W W W W W W W W W W W W W W W W W W W W W W W W W W W W W W W W W W 
W r r c c c c c c c c c c c c c c c c c c c c c c c c c c c c c c c c c c c c c c c c c c c c c c y y c c c c W c c c c c c c c c c c c c c c c c c c c c c c c c c c c c c c c c c c c c c c c c wf bf W
W r r c c c c c c c c c c c c c c c c c c c c c c c c c c c c c c c c c c c c c c c c c c c c c c y y c c c W W W c c c c c c c c c c c c c c c c c c c c c c c c c c c c c c c c c c c c c c c c bf wf W
W r r c c c c c c c c c c c c c c c c c c c c c c c c c c c c c c c c c c c c W c c c c c c c c c y y c c W W W W W c c c c c c c c c c c c c c c c c c c c W c c c c c c c c c c c c c c c c c c wf bf W
W r r c c c c c c c c c c c c c c c c c c c c c c c c c c c c c c c c c c c W W W c c c c c c c c y y c c c W W W c c c c c c c c c c c c c c c c c c c c W W W c c c c c c c c c c c c c c c c c bf wf W
W r r c c c c c c c c c c c c c c c c c c c c c c c c c c c c c c c c c c W W W W W c c c c c c c y y c c c c W c c c c c c c c c c c c c c c c c c c c W W W W W c c c c c c c c c c c c c c c c wf bf W
W r r c c c c c c c W c c c c c c c c c c c c c c c c c c c c c c c c c c c W W W c c c c c c c c y y c c c c c c c c c c c c c c c c c c c c c c c c c c W W W c c c c c c c c c c c c c c c c c bf wf W
W r r c c c c c c W W W c c c c c c c c c c c c c c c c c c c c c c c c c c c W c c c c c c c c c y y c c c c c c c c c c c c c c c c c c c c c c c c c c c W c c c c c c c c c c c c c c c c c c wf bf W
W r r c c c c c W W W W W c c c c c c c c c c c W c c c c c c c c c c c c c c c c c c c c c c c c y y c c c c c c c c c c c c c c c c c c c c c c c c c c c c c c c c c c c c c c c c c c c c c c bf wf W
W r r c c c c c c W W W c c c c c c c c c c c W W W c c c c c c c c c c c c c c c c c c c c c c c y y c c c c c c c c c c c c W c c c c c c c c c c c c c c c c c c c c c c c c c c c c c c c c c wf bf W
W r r c c c c c c c W c c c c c c c c c c c W W W W W c c c c c c c c c c c c c c c c c c c c c c y y c c c c c c c c c c c W W W c c c c c c c c c c c c c c c c c c W c c c c c c c c c c c c c bf wf W
W r r c c c c c c c c c c c c c c c c c c c c W W W c c c c c c c c W c c c c c c c c c c c c c c y y c c c c c c c c c c W W W W W c c c c c c c c c c c c c c c c W W W c c c c c c c c c c c c wf bf W
W r r c c c c c c c c c c c c c c c c c c c c c W c c c c c c c c W W W c c c c c c c c c c c c c y y c c c c c c c c c c c W W W c c c c c c c c c c c c c c c c W W W W W c c c c c c c c c c c bf wf W
W r r c c c c c c c c c c c c c c c c c c c c c c c c c c c c c W W W W W c c c c c c c c W c c c y y c c c c c c c c c c c c W c c c c c c c c c c c c c c c c c c W W W c c c c c c c c c c c c wf bf W
W r r c c c c c c c c c c c c c c c c c c c c c c c c c c c c c c W W W c c c c c c c c W W W c c y y c c c c c c c c c c c c c c c c c c c c c c c c c c c c c c c c W c c c c c c c c c c c c c bf wf W
W r r c c c c c c c c c c c c c W c c c c c c c c c c c c c c c c c W c c c c c c c c W W W W W c y y c c c c c c c c c c c c c c c c c c c c c c c c c c c c c c c c c c c c c c c c c c c c c c wf bf W
W r r c c c c c c c c c c c c W W W c c c c c c c c c c c c c c c c c c c c c c c c c c W W W c c y y c c c c c c c c W c c c c c c c c c c c c c c c c c c c c c c c c c c c c c c c c c c c c c bf wf W
W r r c c c c c c c c c c c W W W W W c c c c c c c c c c c c c c c c c c c c c c c c c c W c c c y y c c c c c c c W W W c c c c c c c c c c c c W c c c c c c c c c c c c c c c c c c c W c c c wf bf W
W r r c c c c c c c c c c c c W W W c c c c c c c c c c c c c c c c c c c c c c c c c c c c c c c y y c c c c c c W W W W W c c c c c c c c c c W W W c c c c c c c c c c c c c c c c c W W W c c bf wf W
W r r c c c c c c c c c c c c c W c c c c c c c c c c c c c W c c c c c c c c c c c c c c c c c c y y c c c c c c c W W W c c c c c c c c c c W W W W W c c c c c c c c c c c c c c c W W W W W c wf bf W
W r r c c c c c c c c c c c c c c c c c c c c c c c c c c W W W c c c c c c c c c c c c c c c c c y y c c c c c c c c W c c c c c c c c c c c c W W W c c c c c c c c c c c c c c c c c W W W c c bf wf W
W r r c c c c c c c c c c c c c c c c c c c c c c c c c W W W W W c c c c c c c c c c c c c c c c y y c c c c c c c c c c c c c c c c c c c c c c W c c c c c c c c c c c c c c c c c c c W c c c wf bf W
W r r c c c c c c c c c c c c c c c c c c c c c c c c c c W W W c c c c c c c c c c c c c c c c c y y c c c c c c c c c c c c c c c c c c c c c c c c c c c c c c c c c c c c c c c c c c c c c c bf wf W
W r r c c c c c c c c c c c c c c c c c c c c c c c c c c c W c c c c c c c c c c c c c c c c c c y y c c c c c c c c c c c c c c c c c c c c c c c c c c c c c c c c c c c c c c c c c c c c c c wf bf W
W W W W W W W W W W W W W W W W W W W W W W W W W W W W W W W W W W W W W W W W W W W W W W W W W W W W W W W W W W W W W W W W W W W W W W W W W W W W W W W W W W W W W W W W W W W W W W W W W W W W 