100 25
W W W W W W W W W W W W W W W W W W W W W W W W W W W W W W W W W W W W W W W W W W W W W W W W W W W W W W W W W W W W W W W W W W W W W W W W W W W W W W W W W W W W W W W W W W W W W W W W W W W W 
W r r c c c c c c c c c c c c c c c c c c c c c c c c c c c c c c c c c c c c W W W W W W W W W W wf wf c c c c c c c c c c c c c c c c c c c c c c c c c c c c c c c c c c c c c c W W W W W W W W wf bf W
W r r c c c c c c c c c c c c c c c c c c c c c c c c c c c c c c c c c c c c c W W W W W W W W W wf wf c c c c c c c c c c c c c c c c c c c c c c c c c c c c c c c c c c c c c c c W W W W W W W bf wf W
W r r c c c c c c c c c c c c c c c c c c c c c c c c c c c c c c c c c c c c c c W W W W W W W W wf wf c c c c c c c c c c c c c c c c c c c c c c c c c c c c c c c c c c c c c c c c W W W W W W wf bf W
W r r c c c c c c c c c c c c c c c c c c c c c c c c c c c c c c c c c c c c c c c W W W W W W W wf wf c c c c c c c c c c c c c W W W W W W W W W W W W W W W c c c c c c c c c c c c c W W W W W bf wf W
W r r c c c c c c c c c c c c c c c c c c c c c c c c c c c c c c c c c c c c c c c c W W W W W W wf wf c c c c c c c c c c c c c W W W W W W W W W W W W W W W c c c c c c c c c c c c c c W W W W wf bf W
W r r c c c c c c c c c c c c c c c c c c c c c c c c c c c c c c c c c c c c c c c c c W W W W W wf wf c c c c c c c c c c c c c W W W W W W W W W W W W W W W c c c c c c c c c c c c c c c W W W bf wf W
W r r c c c c c c c c c c c c c c c c c c c c c c c c c c c c c c c c c c c c c c c c c c W W W W wf wf c c c c c c c c c c c c c W W W W W W W W W W W W W W W c c c c c c c c c c c c c c c c W W wf bf W
W r r c c c c c c c c c c c c c c c c W W W W W W W W W W W W W W W W c c c c c c c c c c c W W W wf wf c c c c c c c c c c c c c W W W c c c c c c c c c W W W c c c c c c c c c c c c c c c c c W bf wf W
W r r c c c c c c c c c c c c c c c W W W W W W W W W W W W W W W W W W c c c c c c c c c c c W W wf wf c c c c c c c c c c c c c W W c c c c c c c c c c c W W c c c c c c c c c c c c c c c c c c wf bf W
W r r c c c c c c c c c c c c c c W W W W W W W W W W W W W W W W W W W W c c c c c c c c c c c W wf wf c c c c c c c c c c c c c W c c c c c c c c c c c c c W c c c c c c c c c c c c c c c c c c bf wf W
W r r c c c c c c c c c c c c c W W W W W W W W W W W W W W W W W W W W W W c c c c c c c c c c c wf wf c c c c c c c c c c c c c c c c c c c c c c c c c c c c c c c c c c c c c c c c c c c c c c wf bf W
W r r c c c c c c c c c c c c W W W W W W W W W W W W W W W W W W W W W W W W c c c c c c c c c c wf wf c c c c c c c c c c c c c c c c c c c c c c c c c c c c c c c c c c c c c c c c c c c c c c bf wf W
W r r c c c c c c c c c c c c c W W W W W W W W W W W W W W W W W W W W W W c c c c c c c c c c c wf wf c c c c c c c c c c c c c c c c c c c c c c c c c c c c c c c c c c c c c c c c c c c c c c wf bf W
W r r c c c c c c c c c c c c c c W W W W W W W W W W W W W W W W W W W W c c c c c c c c c c c W wf wf c c c c c c c c c c c c c W c c c c c c c c c c c c c W c c c c c c c c c c c c c c c c c c bf wf W
W r r c c c c c c c c c c c c c c c W W W W W W W W W W W W W W W W W W c c c c c c c c c c c W W wf wf c c c c c c c c c c c c c W W c c c c c c c c c c c W W c c c c c c c c c c c c c c c c c c wf bf W
W r r c c c c c c c c c c c c c c c c W W W W W W W W W W W W W W W W c c c c c c c c c c c W W W wf wf c c c c c c c c c c c c c W W W c c c c c c c c c W W W c c c c c c c c c c c c c c c c c W bf wf W
W r r c c c c c c c c c c c c c c c c c c c c c c c c c c c c c c c c c c c c c c c c c c W W W W wf wf c c c c c c c c c c c c c W W W W W W W W W W W W W W W c c c c c c c c c c c c c c c c W W wf bf W
W r r c c c c c c c c c c c c c c c c c c c c c c c c c c c c c c c c c c c c c c c c c W W W W W wf wf c c c c c c c c c c c c c W W W W W W W W W W W W W W W c c c c c c c c c c c c c c c W W W bf wf W
W r r c c c c c c c c c c c c c c c c c c c c c c c c c c c c c c c c c c c c c c c c W W W W W W wf wf c c c c c c c c c c c c c W W W W W W W W W W W W W W W c c c c c c c c c c c c c c W W W W wf bf W
W r r c c c c c c c c c c c c c c c c c c c c c c c c c c c c c c c c c c c c c c c W W W W W W W wf wf c c c c c c c c c c c c c W W W W W W W W W W W W W W W c c c c c c c c c c c c c W W W W W bf wf W
W r r c c c c c c c c c c c c c c c c c c c c c c c c c c c c c c c c c c c c c c W W W W W W W W wf wf c c c c c c c c c c c c c c c c c c c c c c c c c c c c c c c c c c c c c c c c W W W W W W wf bf W
W r r c c c c c c c c c c c c c c c c c c c c c c c c c c c c c c c c c c c c c W W W W W W W W W wf wf c c c c c c c c c c c c c c c c c c c c c c c c c c c c c c c c c c c c c c c W W W W W W W bf wf W
W r r c c c c c c c c c c c c c c c c c c c c c c c c c c c c c c c c c c c c W W W W W W W W W W wf wf c c c c c c c c c c c c c c c c c c c c c c c c c c c c c c c c c c c c c c W W W W W W W W wf bf W
W W W W W W W W W W W W W W W W W W W W W W W W W W W W W W W W W W W W W W W W W W W W W W W W W W W W W W W W W W W W W W W W W W W W W W W W W W W W W W W W W W W W W W W W W W W W W W W W W W W W 