40 20
W W W W W W W W W W W W W W W W W W W W W W W W W W W W W W W W W W W W W W W W 
W r r c c c c c c c c c c c W c c c c c c c c c c c c c c c c c c c c c c bf wf W
W r r c c c c c c c c c c c W c c c c c c c c c c c c c c c c c c c c c c bf wf W
W r r c c c c c c c c c c c W c c c c c c c c c c c c c c c c c c c c c c bf wf W
W r r c c c c c c c c c c c W c c c c c c c c c c c c c c c c W c c c c c bf wf W
W r r c c c c c c c c c c c W W W W c c c c c c c c c c c c c W c c c c c bf wf W
W r r c c c c c c c c c c c c c c W c c c c c c c c c c c c c W c c c c c bf wf W
W r r c c c c c c c c c c c c c c W c c c c c c c c c c c c c W c c c c c bf wf W
W r r c c c c c c c c c c c c c c W c c c c c c c c c c W W W W c c c c c bf wf W
W r r c c c c c c c c c c c c c c W c c c c c c c c c c c c W c c c c c c bf wf W
W r r c c c c c c c c c c c c c c c c c c c c c c c c c c c W c c c c c c bf wf W
W r r c c c c c c c c c c c c c c c c c c c c c c c c c c c W c c c c c c bf wf W
W r r c c c c c c c c c c c c c c c c c c c c c c c c c c c W c c c c c c bf wf W
W r r c c c c c c c c c c c c c c c c c c c W c c c c c c c W c c c c c c bf wf W
W r r c c c c c c c c c W c c c c c c c c c W c c c c c c c c c c c c c c bf wf W
W r r c c c c c c c c c W c c c c c c c c c W c c c c c c c c c c c c c c bf wf W
W r r c c c c c c c c c W c c c c c c c c c W c c c c c c c c c c c c c c bf wf W
W r r c c c c c c c c c W c c c c c c c c c W c c c c c c c c c c c c c c bf wf W
W r r c c c c c c c c c W c c c c c c c c c W c c c c c c c c c c c c c c bf wf W
W W W W W W W W W W W W W W W W W W W W W W W W W W W W W W W W W W W W W W W W 
