100 25
W W W W W W W W W W W W W W W W W W W W W W W W W W W W W W W W W W W W W W W W W W W W W W W W W W W W W W W W W W W W W W W W W W W W W W W W W W W W W W W W W W W W W W W W W W W W W W W W W W W W 
W r r c c c c c c W c c c c c c c c c c c c c W c c c c c c c c c c c c c c c c c c c c W c c c c y y c c c c c c c c c W c c c c c c c c c c c c c c W c c c c W c c c c c c c c c c c c c c c c wf bf W
W r r c c c c c c W c c c c c c c c c c c c c W c c c c c c W c c c c c c c c c c c c c W c c c c y y c c c c c c c c c W c c c c c c c c c W c c c c W c c c c W c c c c W c c c c c c c c c W c bf wf W
W r r c c c c c c W c c c c c c c c c c c c c W c c c c c c W c c c c c c c c c c c c c c c c c c y y c c c c W c c c c W c c c c c c c c c W c c c c W c c c c c c c c c W c c c c W c c c c W c wf bf W
W r r c c c c c c W c c c c c c W c c c c c c c c c c c c c W c c c c c c c c c c c c c c c c c c y y c c c c W c c c c c c c c c W c c c c W c c c c c c c c c c c c c c W c c c c W c c c c W c bf wf W
W r r c c c c c c c c c c c c c W c c c c c c c c c c c c c W c c c c c c W c c c c c c c c c c c y y c c c c W c c c c c c c c c W c c c c c c c c c c c c c c c c c c c c c c c c W c c c c c c wf bf W
W r r c c c c c c c c c c c c c W c c c c c c c c c c c c c c c c c c c c W c c c c c c c c c c c y y c c c c c c c c c c c c c c W c c c c c c c c c c c c c c W c c c c c c c c c c c c c c c c bf wf W
W r r c c c c c c c c c c c c c W c c c c c c c c c c c c c c c c c c c c W c c c c c c W c c c c y y c c c c c c c c c W c c c c c c c c c c c c c c W c c c c W c c c c c c c c c c c c c c c c wf bf W
W r r c c c c c c c c c c c c c c c c c c c c W c c c c c c c c c c c c c W c c c c c c W c c c c y y c c c c c c c c c W c c c c c c c c c W c c c c W c c c c W c c c c W c c c c c c c c c W c bf wf W
W r r c c c c c c W c c c c c c c c c c c c c W c c c c c c c c c c c c c c c c c c c c W c c c c y y c c c c W c c c c W c c c c c c c c c W c c c c W c c c c c c c c c W c c c c W c c c c W c wf bf W
W r r c c c c c c W c c c c c c c c c c c c c W c c c c c c W c c c c c c c c c c c c c W c c c c y y c c c c W c c c c c c c c c W c c c c W c c c c c c c c c c c c c c W c c c c W c c c c W c bf wf W
W r r c c c c c c W c c c c c c c c c c c c c W c c c c c c W c c c c c c c c c c c c c c c c c c y y c c c c W c c c c c c c c c W c c c c c c c c c c c c c c c c c c c c c c c c W c c c c c c wf bf W
W r r c c c c c c W c c c c c c W c c c c c c c c c c c c c W c c c c c c c c c c c c c c c c c c y y c c c c c c c c c c c c c c W c c c c c c c c c c c c c c W c c c c c c c c c c c c c c c c bf wf W
W r r c c c c c c c c c c c c c W c c c c c c c c c c c c c W c c c c c c W c c c c c c c c c c c y y c c c c c c c c c W c c c c c c c c c c c c c c W c c c c W c c c c c c c c c c c c c c c c wf bf W
W r r c c c c c c c c c c c c c W c c c c c c c c c c c c c c c c c c c c W c c c c c c c c c c c y y c c c c c c c c c W c c c c c c c c c W c c c c W c c c c W c c c c W c c c c c c c c c W c bf wf W
W r r c c c c c c c c c c c c c W c c c c c c c c c c c c c c c c c c c c W c c c c c c W c c c c y y c c c c W c c c c W c c c c c c c c c W c c c c W c c c c c c c c c W c c c c W c c c c W c wf bf W
W r r c c c c c c c c c c c c c c c c c c c c W c c c c c c c c c c c c c W c c c c c c W c c c c y y c c c c W c c c c c c c c c W c c c c W c c c c c c c c c c c c c c W c c c c W c c c c W c bf wf W
W r r c c c c c c W c c c c c c c c c c c c c W c c c c c c c c c c c c c c c c c c c c W c c c c y y c c c c W c c c c c c c c c W c c c c c c c c c c c c c c c c c c c c c c c c W c c c c c c wf bf W
W r r c c c c c c W c c c c c c c c c c c c c W c c c c c c W c c c c c c c c c c c c c W c c c c y y c c c c c c c c c c c c c c W c c c c c c c c c c c c c c W c c c c c c c c c c c c c c c c bf wf W
W r r c c c c c c W c c c c c c c c c c c c c W c c c c c c W c c c c c c c c c c c c c c c c c c y y c c c c c c c c c W c c c c c c c c c c c c c c W c c c c W c c c c c c c c c c c c c c c c wf bf W
W r r c c c c c c W c c c c c c W c c c c c c c c c c c c c W c c c c c c c c c c c c c c c c c c y y c c c c c c c c c W c c c c c c c c c W c c c c W c c c c W c c c c W c c c c c c c c c W c bf wf W
W r r c c c c c c c c c c c c c W c c c c c c c c c c c c c W c c c c c c W c c c c c c c c c c c y y c c c c W c c c c W c c c c c c c c c W c c c c W c c c c c c c c c W c c c c W c c c c W c wf bf W
W r r c c c c c c c c c c c c c W c c c c c c c c c c c c c c c c c c c c W c c c c c c c c c c c y y c c c c W c c c c c c c c c W c c c c W c c c c c c c c c c c c c c W c c c c W c c c c W c bf wf W
W r r c c c c c c c c c c c c c W c c c c c c c c c c c c c c c c c c c c W c c c c c c W c c c c y y c c c c W c c c c c c c c c W c c c c c c c c c c c c c c c c c c c c c c c c W c c c c c c wf bf W
W W W W W W W W W W W W W W W W W W W W W W W W W W W W W W W W W W W W W W W W W W W W W W W W W W W W W W W W W W W W W W W W W W W W W W W W W W W W W W W W W W W W W W W W W W W W W W W W W W W W 